7 9
#########
#.......#
#.......#
#.S...E.#
#.......#
#.......#
#########